#######     ####      ### ###    ###    ########       #########     ### ###    #####        ######    ###   #####     #### #####
#     #######  ######## ### ###### ######      #########       ####### ### ######   ##########    ###### #####   #######  ###   #
# +---------------------------------#--+     +-------------------------#-------+   ##   +---#-------------------------#----+    #
# |....................................####  |.................................|   #    |..................................| ####
# |....................................|  ####.................................###### ###..................................| #  #
# +--------------+.........+----#------+     |.................................|    ### |..................................| # ##
#####      #######.........|    #            |.........+---#-------------------+    #   |..........+------------+..........|##  #
#   #   ####     |.........|    #       ######.........|   ##########################   |..........###       ####..........|#  ##
# #######  #     |.........##############    |.........+-----------------------+   #    |..........| ##      #  |..........|#   #
###     #  #######.........|       #         |.................................|   #    |..........|  ##     #  |..........|##  #
# +-----#--+  #  |.........| ####  ######### |.................................#####  ###..........|   ##    ####..........| #  #
# |........|  #  |.........| #  #          # |.........+-----#--------#--------+     ## |..........|    ##    # |..........| ## #
# |........|  ####.........| #  #####      # |.........|     ###############        ##  |..........|     ##   ###..........|  # #
# |........####  |.........###      #      # |.........+----------#--------#---+   ##   |..........|      ##    |..........|  # #
# +........+--#--+.........|    ############ |.................................|  ##    |..........|       ###  |..........| ## #
# |........................|  ###            |.................................|  #  ####..........######    ####..........| #  #
# |........................#### ####### ######.................................|  ####  |..........|    ######  |..........| #  #
# +------------#-----------+  #    #  ###    +---------------------------------+        +----------+            +------#---+ #  #
#  #######   ####       ####  #    #    ####     ###  ###########        ### ######    ######       ####     ###  #######  ###  #
####     #####  #########  ##############  ####### ####         ########## ###    ######    #########  ####### ####     #### ####
